,SEASON,SCHOOL,CONF,G,GS,MP,FG,FGA,FG%,2P,2PA,2P%,3P,3PA,FT,FTA,FT%,ORB,DRB,TRB,AST,STL,BLK,TOV,PF,PTS,COLLEGE_URL,3P%
0,2012-13,Pitt,Big East,17,17,413,50,92,0.543,50,92,0.543,0,0,17,36,0.472,43,61,104,10,10,37,19,29,117,/players/steven-adams-1.html,0.0
1,2016-17,Kentucky,SEC,18,18,557,86,129,0.667,86,128,0.672,0,1,79,117,0.675,46,87,133,8,14,29,31,49,251,/players/edrice-adebayo-1.html,0.0
2,2016-17,Texas,Big 12,18,18,622,118,197,0.599,118,194,0.608,0,3,55,94,0.585,59,117,176,12,12,31,51,35,291,/players/jarrett-allen-1.html,0.0
3,2017-18,Dayton,A-10,16,0,213,28,46,0.609,27,41,0.659,1,5,26,46,0.565,14,27,41,6,3,11,18,27,83,/players/kostas-antetokounmpo-1.html,0.2
4,2015-16,Indiana,Big Ten,18,0,281,40,75,0.533,31,53,0.585,9,22,16,29,0.552,23,36,59,11,17,13,11,30,105,/players/og-anunoby-1.html,0.409
5,2016-17,Indiana,Big Ten,6,3,153,21,44,0.477,18,33,0.545,3,11,10,16,0.625,11,16,27,9,11,6,13,12,55,/players/og-anunoby-1.html,0.273
6,2017-18,Arizona,Pac-12,18,18,623,139,226,0.615,135,217,0.622,4,9,81,105,0.771,65,141,206,28,9,41,38,40,363,/players/deandre-ayton-1.html,0.444
7,2017-18,Duke,ACC,14,13,493,109,185,0.589,101,161,0.627,8,24,56,90,0.622,57,109,166,20,16,16,36,25,282,/players/marvin-bagleyiii-1.html,0.333
8,2016-17,UCLA,Pac-12,18,18,633,104,183,0.568,63,85,0.741,41,98,34,51,0.667,20,97,117,133,41,12,46,34,283,/players/lonzo-ball-1.html,0.418
9,2016-17,TCU,Big 12,18,0,309,36,76,0.474,28,48,0.583,8,28,8,12,0.667,13,35,48,13,3,5,19,35,88,/players/desmond-bane-1.html,0.286
10,2017-18,TCU,Big 12,18,17,564,84,158,0.532,54,91,0.593,30,67,43,52,0.827,10,59,69,47,17,3,31,42,241,/players/desmond-bane-1.html,0.448
11,2018-19,TCU,Big 12,18,18,666,112,228,0.491,75,147,0.51,37,81,29,33,0.879,30,68,98,35,22,6,28,50,290,/players/desmond-bane-1.html,0.457
12,2019-20,TCU,Big 12,18,18,648,110,252,0.437,52,124,0.419,58,128,24,31,0.774,22,86,108,74,23,11,45,39,302,/players/desmond-bane-1.html,0.453
13,2010-11,UNC,ACC,16,15,456,95,221,0.43,68,138,0.493,27,83,38,50,0.76,32,57,89,17,9,8,31,27,255,/players/harrison-barnes-1.html,0.325
14,2011-12,UNC,ACC,16,15,481,98,227,0.432,77,165,0.467,21,62,64,87,0.736,33,53,86,14,18,5,29,34,281,/players/harrison-barnes-1.html,0.339
15,2020-21,Florida State,ACC,14,2,335,59,117,0.504,54,95,0.568,5,22,27,40,0.675,23,41,64,58,21,8,29,32,150,/players/scottie-barnes-1.html,0.227
16,2011-12,Florida,SEC,16,16,553,69,159,0.434,47,89,0.528,22,70,70,85,0.824,20,92,112,30,22,15,31,38,230,/players/bradley-beal-1.html,0.314
17,2014-15,Oregon,Pac-12,17,14,440,40,65,0.615,40,65,0.615,0,0,9,18,0.5,33,71,104,23,17,40,17,51,89,/players/jordan-bell-1.html,0.0
18,2015-16,Oregon,Pac-12,18,1,350,51,83,0.614,51,83,0.614,0,0,16,33,0.485,26,58,84,22,14,26,29,47,118,/players/jordan-bell-1.html,0.0
19,2016-17,Oregon,Pac-12,18,18,509,86,131,0.656,85,125,0.68,1,6,29,44,0.659,44,93,137,44,29,31,23,34,202,/players/jordan-bell-1.html,0.167
20,2018-19,Villanova,Big East,18,15,562,61,126,0.484,30,53,0.566,31,73,9,16,0.563,45,55,100,22,18,3,12,41,162,/players/saddiq-bey-1.html,0.425
21,2019-20,Villanova,Big East,18,18,635,106,226,0.469,47,104,0.452,59,122,40,54,0.741,19,56,75,38,17,5,30,47,311,/players/saddiq-bey-1.html,0.484
22,2014-15,Kentucky,SEC,18,0,427,72,153,0.471,44,86,0.512,28,67,35,43,0.814,10,30,40,22,5,0,17,23,207,/players/devin-booker-2.html,0.418
23,2015-16,Oregon,Pac-12,18,17,471,75,134,0.56,55,76,0.724,20,58,50,66,0.758,41,80,121,7,15,55,13,54,220,/players/chris-boucher-1.html,0.345
24,2016-17,Oregon,Pac-12,18,1,404,74,154,0.481,50,87,0.575,24,67,23,43,0.535,21,74,95,6,5,41,15,47,195,/players/chris-boucher-1.html,0.358
25,2015-16,Villanova,Big East,18,0,361,36,65,0.554,29,41,0.707,7,24,28,34,0.824,12,39,51,14,17,12,9,48,107,/players/mikal-bridges-1.html,0.292
26,2016-17,Villanova,Big East,18,18,562,65,124,0.524,41,62,0.661,24,62,31,33,0.939,20,65,85,30,37,20,30,48,185,/players/mikal-bridges-1.html,0.387
27,2017-18,Villanova,Big East,18,18,607,116,226,0.513,71,114,0.623,45,112,51,58,0.879,24,67,91,39,25,16,27,46,328,/players/mikal-bridges-1.html,0.402
28,2011-12,Virginia,ACC,14,1,333,35,80,0.438,25,48,0.521,10,32,11,15,0.733,7,27,34,14,9,1,19,20,91,/players/malcolm-brogdon-1.html,0.313
29,2013-14,Virginia,ACC,18,18,600,87,195,0.446,65,142,0.458,22,53,71,80,0.888,22,82,104,58,23,2,17,33,267,/players/malcolm-brogdon-1.html,0.415
30,2014-15,Virginia,ACC,18,18,615,86,204,0.422,60,131,0.458,26,73,52,58,0.897,8,68,76,42,17,7,32,40,250,/players/malcolm-brogdon-1.html,0.356
31,2015-16,Virginia,ACC,18,18,626,125,249,0.502,86,154,0.558,39,95,70,77,0.909,8,65,73,46,17,3,32,39,359,/players/malcolm-brogdon-1.html,0.411
32,2010-11,Providence,Big East,18,17,696,162,344,0.471,125,230,0.543,37,114,107,139,0.77,37,69,106,45,22,20,57,55,468,/players/marshon-brooks-1.html,0.325
33,2015-16,California,Pac-12,18,18,526,95,206,0.461,76,151,0.503,19,55,77,119,0.647,18,83,101,41,14,16,52,52,286,/players/jaylen-brown-1.html,0.345
34,2014-15,Elon,CAA,18,11,498,80,217,0.369,52,141,0.369,28,76,81,112,0.723,27,61,88,59,22,8,61,51,269,/players/elijah-bryant-1.html,0.368
35,2016-17,BYU,WCC,16,7,434,68,149,0.456,45,82,0.549,23,67,52,67,0.776,11,49,60,43,15,6,26,38,211,/players/elijah-bryant-1.html,0.343
36,2017-18,BYU,WCC,18,18,654,107,221,0.484,62,105,0.59,45,116,73,84,0.869,6,120,126,45,24,10,47,39,332,/players/elijah-bryant-1.html,0.388
37,2011-12,Michigan,Big Ten,18,17,676,96,220,0.436,66,140,0.471,30,80,62,80,0.775,12,50,62,78,16,7,46,25,284,/players/trey-burke-1.html,0.375
38,2012-13,Michigan,Big Ten,18,18,659,124,273,0.454,86,179,0.48,38,94,77,97,0.794,10,49,59,116,36,8,36,36,363,/players/trey-burke-1.html,0.404
39,2010-11,Marquette,Big East,18,16,658,95,192,0.495,86,164,0.524,9,28,103,128,0.805,47,62,109,38,25,7,27,27,302,/players/jimmy-butler-1.html,0.321
40,2015-16,UNC Wilmington,CAA,14,3,88,10,15,0.667,10,15,0.667,0,0,3,10,0.3,10,24,34,0,4,2,5,21,23,/players/devontae-cacok-1.html,0.0
41,2016-17,UNC Wilmington,CAA,18,17,482,87,114,0.763,87,114,0.763,0,0,33,57,0.579,72,116,188,4,26,26,23,59,207,/players/devontae-cacok-1.html,0.0
42,2017-18,UNC Wilmington,CAA,18,16,569,122,223,0.547,122,223,0.547,0,0,66,110,0.6,97,164,261,13,20,12,38,70,310,/players/devontae-cacok-1.html,0.0
43,2018-19,UNC Wilmington,CAA,18,17,555,118,202,0.584,117,201,0.582,1,1,48,83,0.578,79,165,244,16,17,10,39,59,285,/players/devontae-cacok-1.html,1.0
44,2011-12,Georgia,SEC,16,15,540,76,195,0.39,42,86,0.488,34,109,24,33,0.727,18,64,82,19,32,4,18,31,210,/players/kentavious-caldwell-pope-1.html,0.312
45,2012-13,Georgia,SEC,18,17,613,103,235,0.438,55,115,0.478,48,120,78,93,0.839,17,102,119,30,35,11,38,36,332,/players/kentavious-caldwell-pope-1.html,0.4
46,2011-12,Syracuse,Big East,12,0,96,12,18,0.667,7,11,0.636,5,7,4,6,0.667,4,9,13,15,7,1,5,11,33,/players/michael-carter-williams-1.html,0.714
47,2012-13,Syracuse,Big East,18,18,662,75,192,0.391,57,131,0.435,18,61,62,80,0.775,27,54,81,103,48,8,53,42,230,/players/michael-carter-williams-1.html,0.295
48,2012-13,Texas A&M,SEC,18,10,465,36,102,0.353,27,70,0.386,9,32,21,37,0.568,14,41,55,61,33,6,47,63,102,/players/alex-caruso-1.html,0.281
49,2013-14,Texas A&M,SEC,18,17,547,48,112,0.429,40,83,0.482,8,29,39,59,0.661,5,56,61,89,34,11,40,55,143,/players/alex-caruso-1.html,0.276
50,2014-15,Texas A&M,SEC,18,18,604,62,136,0.456,42,87,0.483,20,49,38,53,0.717,13,81,94,92,32,2,55,40,182,/players/alex-caruso-1.html,0.408
51,2015-16,Texas A&M,SEC,18,18,526,53,107,0.495,35,69,0.507,18,38,27,36,0.75,17,46,63,93,34,8,38,45,151,/players/alex-caruso-1.html,0.474
52,2012-13,Kentucky,SEC,14,10,351,54,84,0.643,54,84,0.643,0,0,17,47,0.362,32,57,89,12,10,31,28,40,125,/players/willie-cauley-stein-1.html,0.0
53,2013-14,Kentucky,SEC,18,9,402,47,82,0.573,47,82,0.573,0,0,20,41,0.488,39,49,88,9,21,35,17,47,114,/players/willie-cauley-stein-1.html,0.0
54,2014-15,Kentucky,SEC,18,17,474,56,98,0.571,56,98,0.571,0,0,32,57,0.561,38,74,112,17,20,27,31,38,144,/players/willie-cauley-stein-1.html,0.0
55,2015-16,Washington,Pac-12,18,18,467,93,175,0.531,82,140,0.586,11,35,39,59,0.661,48,50,98,15,14,31,34,79,236,/players/marquese-chriss-1.html,0.314
56,2010-11,Belmont,A-Sun,20,20,506,92,184,0.5,46,82,0.561,46,102,28,33,0.848,10,42,52,38,22,3,25,40,258,/players/ian-clark-1.html,0.451
57,2011-12,Belmont,A-Sun,18,18,497,86,182,0.473,34,58,0.586,52,124,23,28,0.821,8,45,53,52,16,1,18,37,247,/players/ian-clark-1.html,0.419
58,2012-13,Belmont,OVC,16,15,529,108,194,0.557,62,96,0.646,46,98,37,45,0.822,4,49,53,46,33,2,42,31,299,/players/ian-clark-1.html,0.469
59,2015-16,San Jose State,MWC,18,0,480,68,99,0.687,67,96,0.698,1,3,35,63,0.556,48,84,132,31,15,30,23,38,172,/players/brandon-clarke-1.html,0.333
60,2016-17,San Jose State,MWC,18,18,623,149,242,0.616,148,241,0.614,1,1,48,90,0.533,50,115,165,49,20,49,38,43,347,/players/brandon-clarke-1.html,1.0
61,2018-19,Gonzaga,WCC,16,15,442,107,157,0.682,105,149,0.705,2,8,43,59,0.729,44,94,138,29,13,52,16,30,259,/players/brandon-clarke-1.html,0.25
62,2010-11,Tulsa,CUSA,15,0,368,48,119,0.403,35,75,0.467,13,44,55,67,0.821,3,26,29,30,13,3,35,35,164,/players/jordan-clarkson-1.html,0.295
63,2011-12,Tulsa,CUSA,16,16,555,96,198,0.485,67,133,0.504,29,65,57,66,0.864,12,40,52,41,17,9,40,32,278,/players/jordan-clarkson-1.html,0.446
64,2013-14,Missouri,SEC,18,18,647,102,242,0.421,86,184,0.467,16,58,90,109,0.826,15,64,79,54,17,2,46,37,310,/players/jordan-clarkson-1.html,0.276
65,2010-11,Cleveland State,Horizon,18,18,648,121,271,0.446,99,204,0.485,22,67,110,131,0.84,12,117,129,113,38,0,55,43,374,/players/norris-cole-1.html,0.328
66,2015-16,Wake Forest,ACC,18,1,250,40,81,0.494,40,81,0.494,0,0,35,53,0.66,25,33,58,6,7,9,16,46,115,/players/john-collins-1.html,0.0
67,2016-17,Wake Forest,ACC,18,18,489,138,216,0.639,138,216,0.639,0,0,89,117,0.761,69,99,168,10,10,29,35,55,365,/players/john-collins-1.html,0.0
68,2011-12,Notre Dame,Big East,18,12,404,43,105,0.41,19,34,0.559,24,71,4,6,0.667,16,67,83,18,10,4,14,28,114,/players/pat-connaughton-1.html,0.338
69,2012-13,Notre Dame,Big East,18,18,586,49,123,0.398,27,53,0.509,22,70,22,30,0.733,16,71,87,35,6,5,17,31,142,/players/pat-connaughton-1.html,0.314
70,2013-14,Notre Dame,ACC,18,18,702,87,204,0.426,46,82,0.561,41,122,35,40,0.875,21,107,128,59,14,7,24,27,250,/players/pat-connaughton-1.html,0.336
71,2014-15,Notre Dame,ACC,18,18,670,69,166,0.416,25,57,0.439,44,109,23,30,0.767,19,116,135,23,9,16,15,40,205,/players/pat-connaughton-1.html,0.404
72,2011-12,Duke,ACC,15,4,194,21,55,0.382,15,28,0.536,6,27,12,19,0.632,0,13,13,27,5,0,9,13,60,/players/quinn-cook-1.html,0.222
73,2012-13,Duke,ACC,18,18,630,90,211,0.427,55,123,0.447,35,88,30,33,0.909,11,58,69,91,23,3,40,47,245,/players/quinn-cook-1.html,0.398
74,2013-14,Duke,ACC,18,9,489,60,161,0.373,29,68,0.426,31,93,33,40,0.825,5,21,26,56,18,0,28,36,184,/players/quinn-cook-1.html,0.333
75,2014-15,Duke,ACC,18,18,683,100,226,0.442,47,93,0.505,53,133,51,60,0.85,8,62,70,46,14,1,24,36,304,/players/quinn-cook-1.html,0.398
76,2010-11,Tennessee State,OVC,18,18,584,88,171,0.515,63,123,0.512,25,48,40,49,0.816,41,104,145,23,24,18,40,59,241,/players/robert-covington-1.html,0.521
77,2011-12,Tennessee State,OVC,16,16,524,112,213,0.526,79,140,0.564,33,73,49,66,0.742,61,77,138,16,24,20,37,52,306,/players/robert-covington-1.html,0.452
78,2012-13,Tennessee State,OVC,7,5,213,36,74,0.486,25,53,0.472,11,21,34,39,0.872,18,37,55,11,16,13,13,14,117,/players/robert-covington-1.html,0.524
79,2020-21,Oklahoma State,Big 12,15,15,545,97,219,0.443,64,139,0.46,33,80,75,89,0.843,12,86,98,49,20,14,68,41,302,/players/cade-cunningham-1.html,0.413
80,2011-12,Kentucky,SEC,16,16,535,97,144,0.674,95,136,0.699,2,8,59,77,0.766,47,99,146,12,23,79,10,26,255,/players/anthony-davis-5.html,0.25
81,2015-16,Ole Miss,SEC,13,0,98,10,23,0.435,7,13,0.538,3,10,7,17,0.412,4,8,12,6,6,2,4,17,30,/players/terence-davis-1.html,0.3
82,2016-17,Ole Miss,SEC,18,15,473,101,222,0.455,79,147,0.537,22,75,48,64,0.75,24,71,95,34,26,4,34,62,272,/players/terence-davis-1.html,0.293
83,2017-18,Ole Miss,SEC,18,13,486,78,213,0.366,53,119,0.445,25,94,43,60,0.717,28,85,113,31,15,14,30,55,224,/players/terence-davis-1.html,0.266
84,2018-19,Ole Miss,SEC,18,17,560,97,221,0.439,59,117,0.504,38,104,47,60,0.783,19,93,112,53,33,7,44,52,279,/players/terence-davis-1.html,0.365
85,2010-11,Saint Mary's,WCC,14,14,519,55,142,0.387,26,68,0.382,29,74,48,54,0.889,17,33,50,68,18,0,37,31,187,/players/matthew-dellavedova-1.html,0.392
86,2011-12,Saint Mary's,WCC,16,16,615,79,171,0.462,50,94,0.532,29,77,76,92,0.826,13,47,60,106,13,2,42,28,263,/players/matthew-dellavedova-1.html,0.377
87,2012-13,Saint Mary's,WCC,16,16,561,75,193,0.389,38,88,0.432,37,105,62,73,0.849,8,49,57,96,21,3,39,26,249,/players/matthew-dellavedova-1.html,0.352
88,2016-17,Villanova,Big East,18,0,496,52,118,0.441,38,64,0.594,14,54,31,40,0.775,16,39,55,35,14,4,28,30,149,/players/donte-divincenzo-1.html,0.259
89,2017-18,Villanova,Big East,18,9,567,96,197,0.487,55,88,0.625,41,109,32,47,0.681,17,68,85,70,26,3,34,35,265,/players/donte-divincenzo-1.html,0.376
90,2016-17,Virginia,ACC,18,0,242,19,34,0.559,19,30,0.633,0,4,12,21,0.571,12,27,39,5,5,18,8,42,50,/players/mamadi-diakite-1.html,0.0
91,2017-18,Virginia,ACC,18,0,231,30,54,0.556,30,54,0.556,0,0,17,21,0.81,7,32,39,4,8,8,13,34,77,/players/mamadi-diakite-1.html,0.0
92,2018-19,Virginia,ACC,18,11,405,58,111,0.523,56,105,0.533,2,6,18,26,0.692,31,51,82,5,6,37,17,39,136,/players/mamadi-diakite-1.html,0.333
93,2019-20,Virginia,ACC,20,20,672,99,202,0.49,89,171,0.52,10,31,62,80,0.775,34,100,134,15,12,27,46,46,270,/players/mamadi-diakite-1.html,0.323
94,2010-11,Louisville,Big East,13,5,224,31,51,0.608,31,51,0.608,0,0,16,29,0.552,21,33,54,13,8,25,12,29,78,/players/gorgui-dieng-1.html,0.0
95,2011-12,Louisville,Big East,18,18,597,64,127,0.504,64,127,0.504,0,0,31,46,0.674,52,104,156,21,27,57,39,64,159,/players/gorgui-dieng-1.html,0.0
96,2012-13,Louisville,Big East,18,18,613,74,143,0.517,74,143,0.517,0,0,53,77,0.688,65,130,195,33,26,51,38,44,201,/players/gorgui-dieng-1.html,0.0
97,2018-19,Illinois,Big Ten,20,20,651,106,245,0.433,74,152,0.487,32,93,52,71,0.732,13,60,73,65,25,6,47,37,296,/players/ayo-dosunmu-1.html,0.344
98,2019-20,Illinois,Big Ten,19,19,674,125,265,0.472,109,211,0.517,16,54,52,70,0.743,14,83,97,67,12,5,51,29,318,/players/ayo-dosunmu-1.html,0.296
99,2020-21,Illinois,Big Ten,17,17,599,124,261,0.475,105,213,0.493,19,48,65,84,0.774,20,77,97,89,19,4,54,33,332,/players/ayo-dosunmu-1.html,0.396
100,2011-12,UConn,Big East,18,18,552,88,175,0.503,88,173,0.509,0,2,13,46,0.283,64,91,155,11,15,46,32,41,189,/players/andre-drummond-1.html,0.0
101,2019-20,Oregon,Pac-12,15,15,498,69,176,0.392,45,97,0.464,24,79,39,49,0.796,23,69,92,24,35,11,21,29,201,/players/chris-duarte-1.html,0.304
102,2020-21,Oregon,Pac-12,16,16,552,102,193,0.528,61,100,0.61,41,93,42,55,0.764,11,66,77,36,30,13,39,23,287,/players/chris-duarte-1.html,0.441
103,2019-20,Georgia,SEC,18,18,634,118,289,0.408,74,138,0.536,44,151,85,107,0.794,15,86,101,45,22,10,53,44,365,/players/anthony-edwards-2.html,0.291
104,2013-14,Kansas,Big 12,15,15,363,58,97,0.598,57,94,0.606,1,3,55,78,0.705,36,96,132,21,12,39,43,48,172,/players/joel-embiid-1.html,0.333
105,2010-11,Vanderbilt,SEC,16,16,404,66,125,0.528,66,125,0.528,0,0,77,109,0.706,41,55,96,3,9,48,34,46,209,/players/festus-ezeli-1.html,0.0
106,2011-12,Vanderbilt,SEC,16,16,371,58,107,0.542,58,107,0.542,0,0,47,83,0.566,36,51,87,4,4,36,36,54,163,/players/festus-ezeli-1.html,0.0
107,2010-11,Morehead State,OVC,18,17,638,110,187,0.588,110,187,0.588,0,0,75,144,0.521,114,159,273,24,32,43,51,61,295,/players/kenneth-faried-1.html,0.0
108,2012-13,Indiana,Big Ten,18,18,528,52,122,0.426,36,76,0.474,16,46,35,47,0.745,7,38,45,61,14,2,36,35,155,/players/kevin-ferrell-1.html,0.348
109,2013-14,Indiana,Big Ten,18,18,654,96,237,0.405,45,108,0.417,51,129,77,94,0.819,5,45,50,68,14,0,46,31,320,/players/kevin-ferrell-1.html,0.395
110,2014-15,Indiana,Big Ten,18,18,658,92,217,0.424,47,102,0.461,45,115,44,54,0.815,13,46,59,93,10,0,30,30,273,/players/kevin-ferrell-1.html,0.391
111,2015-16,Indiana,Big Ten,18,18,648,104,235,0.443,57,126,0.452,47,109,66,83,0.795,12,47,59,92,23,1,51,33,321,/players/kevin-ferrell-1.html,0.431
112,2012-13,Cleveland State,Horizon,16,15,537,81,178,0.455,42,86,0.488,39,92,38,42,0.905,10,61,71,20,17,1,26,34,239,/players/bryn-forbes-1.html,0.424
113,2013-14,Cleveland State,Horizon,15,15,521,63,165,0.382,31,78,0.397,32,87,41,56,0.732,9,31,40,23,8,0,19,23,199,/players/bryn-forbes-1.html,0.368
114,2014-15,Michigan State,Big Ten,18,12,467,51,120,0.425,21,46,0.457,30,74,16,22,0.727,5,20,25,14,15,4,19,30,148,/players/bryn-forbes-1.html,0.405
115,2015-16,Michigan State,Big Ten,18,17,522,95,192,0.495,29,63,0.46,66,129,29,35,0.829,7,32,39,34,6,1,13,28,285,/players/bryn-forbes-1.html,0.512
116,2010-11,St. Joseph's,A-10,16,16,556,67,163,0.411,31,81,0.383,36,82,50,57,0.877,17,68,85,42,27,9,18,39,220,/players/langston-galloway-1.html,0.439
117,2011-12,St. Joseph's,A-10,16,15,573,82,178,0.461,42,84,0.5,40,94,33,40,0.825,21,50,71,36,13,10,24,41,237,/players/langston-galloway-1.html,0.426
118,2012-13,St. Joseph's,A-10,16,16,573,67,180,0.372,33,84,0.393,34,96,18,29,0.621,9,46,55,39,23,4,22,34,186,/players/langston-galloway-1.html,0.354
119,2013-14,St. Joseph's,A-10,16,16,597,85,205,0.415,39,86,0.453,46,119,53,66,0.803,15,53,68,27,17,10,13,37,269,/players/langston-galloway-1.html,0.387
120,2017-18,Kentucky,SEC,18,15,650,95,206,0.461,85,181,0.47,10,25,72,89,0.809,16,56,72,96,22,14,53,27,272,/players/shai-gilgeous-alexander-1.html,0.4
121,2010-11,Michigan State,Big Ten,18,17,573,78,188,0.415,61,137,0.445,17,51,51,70,0.729,45,97,142,73,30,18,40,67,224,/players/draymond-green-1.html,0.333
122,2011-12,Michigan State,Big Ten,18,18,612,102,215,0.474,70,146,0.479,32,69,64,89,0.719,31,159,190,64,28,11,54,48,300,/players/draymond-green-1.html,0.464
123,2016-17,Gonzaga,WCC,15,0,75,16,26,0.615,14,21,0.667,2,5,6,14,0.429,7,10,17,1,2,2,4,6,40,/players/rui-hachimura-1.html,0.4
124,2017-18,Gonzaga,WCC,18,0,390,88,146,0.603,88,136,0.647,0,10,57,71,0.803,18,61,79,12,12,9,21,33,233,/players/rui-hachimura-1.html,0.0
125,2018-19,Gonzaga,WCC,16,16,489,125,197,0.635,120,187,0.642,5,10,65,83,0.783,27,83,110,22,18,13,24,31,320,/players/rui-hachimura-1.html,0.5
126,2018-19,Iowa State,Big 12,18,18,583,35,80,0.438,11,22,0.5,24,58,12,17,0.706,14,35,49,56,24,15,14,19,106,/players/tyrese-haliburton-1.html,0.414
127,2019-20,Iowa State,Big 12,10,10,376,46,102,0.451,24,49,0.49,22,53,19,21,0.905,14,46,60,54,22,8,32,14,133,/players/tyrese-haliburton-1.html,0.415
128,2010-11,Michigan,Big Ten,18,18,575,90,194,0.464,44,90,0.489,46,104,42,59,0.712,11,57,68,35,21,2,28,41,268,/players/tim-hardaway-jr-1.html,0.442
129,2011-12,Michigan,Big Ten,18,18,649,85,213,0.399,58,111,0.523,27,102,57,80,0.713,18,60,78,31,11,8,37,37,254,/players/tim-hardaway-jr-1.html,0.265
130,2012-13,Michigan,Big Ten,18,18,631,96,220,0.436,60,130,0.462,36,90,26,42,0.619,3,74,77,36,13,10,33,39,254,/players/tim-hardaway-jr-1.html,0.4
131,2012-13,Louisville,Big East,18,2,262,38,71,0.535,38,71,0.535,0,0,5,21,0.238,27,31,58,4,10,11,14,19,81,/players/montrezl-harrell-1.html,0.0
132,2013-14,Louisville,AAC,18,18,578,122,205,0.595,121,203,0.596,1,2,34,77,0.442,60,94,154,24,20,29,28,44,279,/players/montrezl-harrell-1.html,0.5
133,2014-15,Louisville,ACC,18,18,659,109,196,0.556,104,180,0.578,5,16,58,100,0.58,57,115,172,23,18,25,33,41,281,/players/montrezl-harrell-1.html,0.313
134,2018-19,Kentucky,SEC,18,18,612,92,191,0.482,60,115,0.522,32,76,58,59,0.983,6,81,87,40,16,3,29,22,274,/players/tyler-herro-1.html,0.421
135,2012-13,Oklahoma,Big 12,14,11,387,45,113,0.398,39,73,0.534,6,40,18,21,0.857,23,38,61,34,17,3,21,30,114,/players/buddy-hield-1.html,0.15
136,2013-14,Oklahoma,Big 12,18,18,602,113,244,0.463,50,97,0.515,63,147,26,33,0.788,29,51,80,35,28,2,33,35,315,/players/buddy-hield-1.html,0.429
137,2014-15,Oklahoma,Big 12,18,18,602,112,256,0.438,65,133,0.489,47,123,62,77,0.805,32,72,104,33,27,3,44,32,333,/players/buddy-hield-1.html,0.382
138,2015-16,Oklahoma,Big 12,18,18,668,146,302,0.483,67,125,0.536,79,177,77,87,0.885,15,84,99,44,20,10,62,45,448,/players/buddy-hield-1.html,0.446
139,2010-11,Washington,Pac-10,18,18,531,70,158,0.443,40,75,0.533,30,83,20,26,0.769,28,54,82,44,10,20,28,39,190,/players/justin-holiday-1.html,0.361
140,2018-19,Iowa State,Big 12,18,17,461,67,173,0.387,42,98,0.429,25,75,18,32,0.563,11,65,76,37,20,8,29,43,177,/players/talen-horton-tucker-1.html,0.333
141,2016-17,Maryland,Big Ten,18,18,557,64,151,0.424,23,47,0.489,41,104,6,12,0.5,8,82,90,57,17,9,29,36,175,/players/kevin-huerter-1.html,0.394
142,2017-18,Maryland,Big Ten,18,18,640,89,185,0.481,50,84,0.595,39,101,59,74,0.797,15,77,92,58,11,10,45,45,276,/players/kevin-huerter-1.html,0.386
143,2019-20,VCU,A-10,18,9,434,70,159,0.44,24,60,0.4,46,99,12,18,0.667,7,40,47,38,14,5,27,43,198,/players/nahshon-hyland-1.html,0.465
144,2020-21,VCU,A-10,12,12,417,76,173,0.439,41,80,0.513,35,93,53,61,0.869,3,64,67,25,24,3,40,25,240,/players/nahshon-hyland-1.html,0.376
145,2015-16,Duke,ACC,18,18,670,104,247,0.421,59,140,0.421,45,107,60,81,0.741,32,104,136,41,15,27,47,37,313,/players/brandon-ingram-1.html,0.421
146,2017-18,Michigan State,Big Ten,18,17,400,71,126,0.563,47,70,0.671,24,56,57,73,0.781,17,70,87,19,10,63,24,54,223,/players/jaren-jacksonjr-1.html,0.429
147,2016-17,Kansas,Big 12,18,18,572,111,223,0.498,91,177,0.514,20,46,58,100,0.58,43,93,136,55,30,15,57,59,300,/players/josh-jackson-2.html,0.435
148,2014-15,UNC,ACC,18,17,514,73,151,0.483,62,113,0.549,11,38,30,45,0.667,26,49,75,44,7,13,23,22,187,/players/justin-jackson-4.html,0.289
149,2015-16,UNC,ACC,18,16,519,85,190,0.447,71,139,0.511,14,51,23,38,0.605,31,35,66,49,6,8,15,34,207,/players/justin-jackson-4.html,0.275
150,2016-17,UNC,ACC,18,17,586,126,290,0.434,74,150,0.493,52,140,37,52,0.712,31,51,82,42,8,6,33,22,341,/players/justin-jackson-4.html,0.371
151,2013-14,Vanderbilt,SEC,18,18,525,82,160,0.513,82,160,0.513,0,0,46,77,0.597,38,79,117,5,7,26,37,67,210,/players/damian-jones-1.html,0.0
152,2014-15,Vanderbilt,SEC,18,17,529,88,165,0.533,88,164,0.537,0,1,50,98,0.51,33,67,100,9,10,37,36,46,226,/players/damian-jones-1.html,0.0
153,2015-16,Vanderbilt,SEC,18,18,478,108,172,0.628,108,171,0.632,0,1,48,84,0.571,44,90,134,15,3,27,36,64,264,/players/damian-jones-1.html,0.0
154,2017-18,Alabama,SEC,17,7,362,29,78,0.372,25,60,0.417,4,18,4,11,0.364,20,45,65,19,19,14,22,40,66,/players/herb-jones-3.html,0.222
155,2018-19,Alabama,SEC,18,13,361,42,91,0.462,40,83,0.482,2,8,22,43,0.512,18,36,54,38,16,8,33,49,108,/players/herb-jones-3.html,0.25
156,2019-20,Alabama,SEC,15,14,410,35,69,0.507,35,64,0.547,0,5,40,63,0.635,38,73,111,32,23,11,13,59,110,/players/herb-jones-3.html,0.0
157,2020-21,Alabama,SEC,18,18,461,63,142,0.444,50,112,0.446,13,30,43,61,0.705,31,74,105,63,32,20,48,52,182,/players/herb-jones-3.html,0.433
158,2010-11,Texas,Big 12,16,16,523,58,135,0.43,35,80,0.438,23,55,19,28,0.679,12,44,56,46,16,5,22,27,158,/players/cory-joseph-1.html,0.418
159,2011-12,Kentucky,SEC,16,16,509,53,125,0.424,51,109,0.468,2,16,52,70,0.743,39,84,123,36,20,16,33,34,160,/players/michael-kidd-gilchrist-1.html,0.125
160,2010-11,Kentucky,SEC,16,16,592,90,208,0.433,54,121,0.446,36,87,59,73,0.808,11,62,73,65,8,3,46,38,275,/players/brandon-knight-1.html,0.414
161,2014-15,Utah,Pac-12,16,0,118,15,37,0.405,10,18,0.556,5,19,6,11,0.545,5,23,28,9,0,3,8,18,41,/players/kyle-kuzma-1.html,0.263
162,2015-16,Utah,Pac-12,18,17,452,73,144,0.507,70,126,0.556,3,18,27,49,0.551,36,70,106,31,9,9,37,37,176,/players/kyle-kuzma-1.html,0.167
163,2016-17,Utah,Pac-12,17,17,537,112,218,0.514,93,169,0.55,19,49,45,68,0.662,47,110,157,37,11,6,34,29,288,/players/kyle-kuzma-1.html,0.388
164,2013-14,UCLA,Pac-12,18,1,465,57,149,0.383,34,87,0.391,23,62,29,41,0.707,10,36,46,34,20,3,19,41,166,/players/zach-lavine-1.html,0.371
165,2010-11,San Diego State,MWC,16,16,526,83,210,0.395,78,183,0.426,5,27,66,86,0.767,59,131,190,42,24,10,39,39,237,/players/kawhi-leonard-1.html,0.185
166,2010-11,Weber State,Big Sky,1,0,2,0,0,0.0,0,0,0.0,0,0,0,0,0.0,0,0,0,0,0,0,0,0,0,/players/damian-lillard-1.html,0.0
167,2011-12,Weber State,Big Sky,16,16,558,112,243,0.461,65,133,0.489,47,110,118,134,0.881,3,67,70,63,25,5,35,32,389,/players/damian-lillard-1.html,0.427
168,2014-15,UCLA,Pac-12,18,18,569,80,163,0.491,63,135,0.467,17,28,38,60,0.633,54,105,159,22,24,10,22,53,215,/players/kevon-looney-1.html,0.607
169,2011-12,Furman,Southern,17,11,397,41,97,0.423,30,63,0.476,11,34,27,42,0.643,8,48,56,29,13,2,28,48,120,/players/jordan-loyd-1.html,0.324
170,2016-17,Arizona,Pac-12,18,18,527,86,177,0.486,54,101,0.535,32,76,58,69,0.841,42,94,136,10,7,6,21,41,262,/players/lauri-markkanen-1.html,0.421
171,2011-12,UNC,ACC,16,0,216,23,63,0.365,23,63,0.365,0,0,15,25,0.6,17,37,54,3,5,3,6,25,61,/players/james-michael-mcadoo-1.html,0.0
172,2012-13,UNC,ACC,18,18,565,105,240,0.438,105,238,0.441,0,2,50,92,0.543,42,87,129,19,27,10,44,43,260,/players/james-michael-mcadoo-1.html,0.0
173,2013-14,UNC,ACC,18,18,537,94,198,0.475,94,198,0.475,0,0,60,123,0.488,55,74,129,30,21,15,25,52,248,/players/james-michael-mcadoo-1.html,0.0
174,2014-15,UNLV,MWC,17,13,552,70,155,0.452,30,62,0.484,40,93,23,31,0.742,13,35,48,57,25,5,27,26,203,/players/patrick-mccaw-1.html,0.43
175,2015-16,UNLV,MWC,18,18,610,79,187,0.422,43,82,0.524,36,105,50,63,0.794,18,83,101,69,40,8,36,39,244,/players/patrick-mccaw-1.html,0.343
176,2010-11,Lehigh,Patriot,14,14,507,103,265,0.389,77,182,0.423,26,83,93,108,0.861,35,88,123,34,34,13,44,27,325,/players/cj-mccollum-1.html,0.313
177,2011-12,Lehigh,Patriot,14,14,487,118,253,0.466,90,175,0.514,28,78,69,84,0.821,20,80,100,48,36,10,23,30,333,/players/cj-mccollum-1.html,0.359
178,2010-11,Tennessee,SEC,1,0,3,0,0,0.0,0,0,0.0,0,0,0,0,0.0,0,0,0,0,0,0,0,0,0,/players/jordan-mcrae-1.html,0.0
179,2011-12,Tennessee,SEC,16,0,353,43,107,0.402,28,59,0.475,15,48,25,36,0.694,12,50,62,26,8,12,21,31,126,/players/jordan-mcrae-1.html,0.313
180,2012-13,Tennessee,SEC,18,18,677,112,251,0.446,74,154,0.481,38,97,84,108,0.778,25,65,90,37,15,16,64,46,346,/players/jordan-mcrae-1.html,0.392
181,2013-14,Tennessee,SEC,18,18,597,103,252,0.409,56,133,0.421,47,119,85,106,0.802,8,58,66,46,8,14,40,44,338,/players/jordan-mcrae-1.html,0.395
182,2016-17,Utah State,MWC,18,16,546,69,155,0.445,35,80,0.438,34,75,28,31,0.903,9,54,63,71,22,5,22,47,200,/players/sam-merrill-1.html,0.453
183,2017-18,Utah State,MWC,18,18,646,108,207,0.522,45,89,0.506,63,118,31,34,0.912,4,54,58,49,19,6,32,43,310,/players/sam-merrill-1.html,0.534
184,2018-19,Utah State,MWC,18,18,667,124,282,0.44,75,153,0.49,49,129,99,111,0.892,8,62,70,79,20,6,34,48,396,/players/sam-merrill-1.html,0.38
185,2019-20,Utah State,MWC,18,18,642,111,238,0.466,61,108,0.565,50,130,82,90,0.911,2,57,59,72,17,3,28,42,354,/players/sam-merrill-1.html,0.385
186,2010-11,Texas A&M,Big 12,16,16,506,73,173,0.422,55,120,0.458,18,53,53,68,0.779,32,56,88,47,19,0,47,31,217,/players/khris-middleton-1.html,0.34
187,2011-12,Texas A&M,Big 12,13,10,378,59,150,0.393,47,101,0.465,12,49,26,38,0.684,15,52,67,21,9,5,26,23,156,/players/khris-middleton-1.html,0.245
188,2011-12,Holy Cross,Patriot,7,0,38,2,5,0.4,0,1,0.0,2,4,0,1,0.0,0,6,6,1,1,2,1,2,6,/players/malcolm-miller-1.html,0.5
189,2012-13,Holy Cross,Patriot,11,11,303,25,51,0.49,17,27,0.63,8,24,16,33,0.485,6,60,66,19,7,6,17,27,74,/players/malcolm-miller-1.html,0.333
190,2013-14,Holy Cross,Patriot,18,18,559,72,156,0.462,51,104,0.49,21,52,40,50,0.8,20,92,112,35,15,34,32,54,205,/players/malcolm-miller-1.html,0.404
191,2014-15,Holy Cross,Patriot,18,18,585,83,172,0.483,48,100,0.48,35,72,70,83,0.843,23,77,100,21,23,25,25,43,271,/players/malcolm-miller-1.html,0.486
192,2015-16,Louisville,ACC,18,5,337,47,112,0.42,38,73,0.521,9,39,25,36,0.694,17,35,52,24,11,3,18,39,128,/players/donovan-mitchell-1.html,0.231
193,2016-17,Louisville,ACC,18,18,616,111,251,0.442,59,121,0.488,52,130,52,63,0.825,14,61,75,52,38,6,29,54,326,/players/donovan-mitchell-1.html,0.4
194,2020-21,USC,Pac-12,20,20,674,112,200,0.56,108,180,0.6,4,20,81,115,0.704,45,123,168,45,19,53,49,37,309,/players/evan-mobley-1.html,0.2
195,2017-18,Murray State,OVC,18,18,640,80,163,0.491,67,116,0.578,13,47,60,78,0.769,35,90,125,112,20,7,49,40,233,/players/temetrius-morant-1.html,0.277
196,2018-19,Murray State,OVC,18,18,665,141,293,0.481,107,201,0.532,34,92,129,156,0.827,18,67,85,194,32,17,94,30,445,/players/temetrius-morant-1.html,0.37
197,2011-12,Oregon State,Pac-12,18,11,383,29,61,0.475,28,58,0.483,1,3,23,49,0.469,39,73,112,26,20,37,23,54,82,/players/eric-moreland-1.html,0.333
198,2012-13,Oregon State,Pac-12,15,8,472,45,83,0.542,43,75,0.573,2,8,24,51,0.471,46,102,148,25,14,33,37,40,116,/players/eric-moreland-1.html,0.25
199,2013-14,Oregon State,Pac-12,18,17,530,56,118,0.475,55,116,0.474,1,2,36,67,0.537,40,147,187,26,12,36,41,43,149,/players/eric-moreland-1.html,0.5
200,2010-11,Kansas,Big 12,16,16,413,86,136,0.632,75,112,0.67,11,24,40,64,0.625,39,87,126,28,14,22,34,41,223,/players/markieff-morris-1.html,0.458
201,2015-16,Washington,Pac-12,18,18,645,110,264,0.417,89,205,0.434,21,59,56,83,0.675,22,77,99,75,35,5,58,54,297,/players/dejounte-murray-1.html,0.356
202,2015-16,Kentucky,SEC,18,18,646,137,288,0.476,70,137,0.511,67,151,63,78,0.808,28,70,98,33,18,6,31,35,404,/players/jamal-murray-1.html,0.444
203,2012-13,Kentucky,SEC,11,11,375,44,69,0.638,44,69,0.638,0,0,29,56,0.518,27,79,106,16,16,60,23,23,117,/players/nerlens-noel-1.html,0.0
204,2013-14,Illinois,Big Ten,18,8,423,57,121,0.471,32,64,0.5,25,57,15,18,0.833,5,27,32,26,10,3,21,26,154,/players/kendrick-nunn-1.html,0.439
205,2014-15,Illinois,Big Ten,18,18,630,78,204,0.382,43,103,0.417,35,101,39,49,0.796,8,64,72,38,21,3,34,36,230,/players/kendrick-nunn-1.html,0.347
206,2015-16,Illinois,Big Ten,17,16,609,85,223,0.381,42,104,0.404,43,119,30,38,0.789,6,80,86,25,23,4,34,43,243,/players/kendrick-nunn-1.html,0.361
207,2017-18,Oakland,Horizon,18,16,702,166,367,0.452,82,158,0.519,84,209,89,105,0.848,18,75,93,64,27,6,53,40,505,/players/kendrick-nunn-1.html,0.402
208,2017-18,Louisville,ACC,11,0,112,20,40,0.5,11,22,0.5,9,18,12,14,0.857,2,21,23,7,8,1,8,13,61,/players/jordan-nwora-1.html,0.5
209,2018-19,Louisville,ACC,18,18,610,106,255,0.416,62,134,0.463,44,121,49,63,0.778,17,112,129,27,13,7,44,42,305,/players/jordan-nwora-1.html,0.364
210,2019-20,Louisville,ACC,20,19,680,112,261,0.429,60,137,0.438,52,124,62,73,0.849,31,132,163,27,14,7,37,45,338,/players/jordan-nwora-1.html,0.419
211,2014-15,Duke,ACC,17,17,540,116,178,0.652,116,178,0.652,0,0,55,101,0.545,70,91,161,24,12,22,47,39,287,/players/jahlil-okafor-1.html,0.0
212,2019-20,Auburn,SEC,15,15,496,58,127,0.457,44,83,0.53,14,44,57,81,0.704,26,42,68,34,16,13,26,44,187,/players/isaac-okoro-1.html,0.318
213,2010-11,Indiana,Big Ten,18,5,342,47,89,0.528,42,72,0.583,5,17,36,52,0.692,23,37,60,12,12,4,21,40,135,/players/victor-oladipo-1.html,0.294
214,2011-12,Indiana,Big Ten,18,16,498,63,142,0.444,59,113,0.522,4,29,56,72,0.778,30,68,98,32,23,14,37,42,186,/players/victor-oladipo-1.html,0.138
215,2012-13,Indiana,Big Ten,18,18,523,91,159,0.572,75,125,0.6,16,34,52,65,0.8,51,69,120,37,36,15,41,47,250,/players/victor-oladipo-1.html,0.471
216,2010-11,Gonzaga,WCC,14,0,156,22,44,0.5,19,33,0.576,3,11,14,29,0.483,16,29,45,5,4,2,12,18,61,/players/kelly-olynyk-1.html,0.273
217,2012-13,Gonzaga,WCC,16,16,427,115,168,0.685,108,154,0.701,7,14,71,92,0.772,36,81,117,32,12,25,38,28,308,/players/kelly-olynyk-1.html,0.5
218,2010-11,Florida,SEC,15,14,534,71,145,0.49,46,88,0.523,25,57,26,45,0.578,35,96,131,55,14,5,28,29,193,/players/chandler-parsons-1.html,0.439
219,2014-15,Fordham,A-10,16,16,534,90,229,0.393,65,147,0.442,25,82,66,79,0.835,28,58,86,16,17,7,43,32,271,/players/eric-paschall-1.html,0.305
220,2016-17,Villanova,Big East,18,7,407,47,89,0.528,41,61,0.672,6,28,10,16,0.625,26,35,61,11,9,11,17,47,110,/players/eric-paschall-1.html,0.214
221,2017-18,Villanova,Big East,16,16,510,71,116,0.612,50,70,0.714,21,46,29,35,0.829,18,54,72,42,21,9,23,40,192,/players/eric-paschall-1.html,0.457
222,2018-19,Villanova,Big East,18,18,671,103,224,0.46,64,114,0.561,39,110,70,89,0.787,17,99,116,40,13,10,35,39,315,/players/eric-paschall-1.html,0.355
223,2011-12,Louisiana,Sun Belt,16,1,338,37,87,0.425,37,82,0.451,0,5,37,76,0.487,17,38,55,46,13,5,52,31,111,/players/elfrid-payton-1.html,0.0
224,2012-13,Louisiana,Sun Belt,20,20,733,121,239,0.506,112,215,0.521,9,24,91,136,0.669,22,82,104,119,50,13,68,43,342,/players/elfrid-payton-1.html,0.375
225,2013-14,Louisiana,Sun Belt,18,18,676,125,232,0.539,119,210,0.567,6,22,86,145,0.593,45,71,116,111,46,12,63,47,342,/players/elfrid-payton-1.html,0.273
226,2010-11,Duke,ACC,16,13,424,43,76,0.566,43,76,0.566,0,0,16,38,0.421,46,109,155,21,11,31,28,49,102,/players/mason-plumlee-1.html,0.0
227,2011-12,Duke,ACC,16,13,434,56,116,0.483,56,116,0.483,0,0,47,75,0.627,42,88,130,23,11,21,28,46,159,/players/mason-plumlee-1.html,0.0
228,2012-13,Duke,ACC,18,18,647,104,187,0.556,104,187,0.556,0,0,80,122,0.656,51,122,173,41,21,26,52,43,288,/players/mason-plumlee-1.html,0.0
229,2013-14,Arkansas,SEC,18,18,528,83,170,0.488,77,154,0.5,6,16,46,63,0.73,46,77,123,23,23,35,24,36,218,/players/bobby-portis-1.html,0.375
230,2014-15,Arkansas,SEC,18,18,562,136,243,0.56,133,231,0.576,3,12,60,76,0.789,71,97,168,22,17,34,31,38,335,/players/bobby-portis-1.html,0.25
231,2011-12,UCLA,Pac-12,18,1,329,31,82,0.378,16,45,0.356,15,37,1,3,0.333,3,33,36,17,6,4,15,27,78,/players/norman-powell-1.html,0.405
232,2012-13,UCLA,Pac-12,18,1,333,30,70,0.429,22,37,0.595,8,33,6,9,0.667,3,31,34,17,6,7,21,35,74,/players/norman-powell-1.html,0.242
233,2013-14,UCLA,Pac-12,18,18,472,71,141,0.504,57,102,0.559,14,39,36,51,0.706,13,40,53,28,20,7,18,48,192,/players/norman-powell-1.html,0.359
234,2014-15,UCLA,Pac-12,18,18,651,117,250,0.468,103,191,0.539,14,59,62,81,0.765,14,72,86,37,36,7,39,42,310,/players/norman-powell-1.html,0.237
235,2018-19,Kentucky,SEC,18,0,297,25,66,0.379,9,24,0.375,16,42,22,27,0.815,0,31,31,19,7,0,12,21,88,/players/immanuel-quickley-1.html,0.381
236,2019-20,Kentucky,SEC,18,14,635,92,214,0.43,48,122,0.393,44,92,104,113,0.92,8,74,82,34,17,3,26,47,332,/players/immanuel-quickley-1.html,0.478
237,2013-14,Kentucky,SEC,18,18,563,80,165,0.485,77,158,0.487,3,7,79,109,0.725,63,123,186,21,13,16,43,45,242,/players/julius-randle-1.html,0.429
238,2010-11,Colorado,Big 12,16,0,358,32,63,0.508,27,49,0.551,5,14,19,33,0.576,49,67,116,14,19,15,16,49,88,/players/andre-roberson-1.html,0.357
239,2011-12,Colorado,Pac-12,18,18,527,74,150,0.493,65,123,0.528,9,27,38,70,0.543,50,147,197,20,24,42,29,39,195,/players/andre-roberson-1.html,0.333
240,2012-13,Colorado,Pac-12,16,15,555,62,138,0.449,51,100,0.51,11,38,21,36,0.583,46,130,176,17,37,20,40,40,156,/players/andre-roberson-1.html,0.289
241,2014-15,Ohio State,Big Ten,18,18,642,123,273,0.451,74,149,0.497,49,124,71,95,0.747,20,93,113,92,26,4,50,40,366,/players/dangelo-russell-1.html,0.395
242,2014-15,Gonzaga,WCC,18,0,412,63,96,0.656,63,96,0.656,0,0,32,53,0.604,38,98,136,19,7,5,22,43,158,/players/domantas-sabonis-1.html,0.0
243,2015-16,Gonzaga,WCC,18,18,591,108,191,0.565,106,183,0.579,2,8,89,119,0.748,47,175,222,40,10,15,49,59,307,/players/domantas-sabonis-1.html,0.25
244,2017-18,Alabama,SEC,16,15,464,83,208,0.399,67,142,0.472,16,66,86,112,0.768,14,45,59,61,13,3,43,41,268,/players/collin-sexton-1.html,0.242
245,2016-17,Wichita State,MVC,18,18,513,79,141,0.56,36,58,0.621,43,83,32,39,0.821,7,45,52,71,13,3,19,34,233,/players/landry-shamet-1.html,0.518
246,2017-18,Wichita State,AAC,17,17,551,69,156,0.442,26,50,0.52,43,106,37,47,0.787,7,49,56,95,11,4,35,28,218,/players/landry-shamet-1.html,0.406
247,2010-11,Georgia Tech,ACC,16,16,531,103,243,0.424,79,158,0.5,24,85,71,94,0.755,33,63,96,58,46,2,40,44,301,/players/iman-shumpert-1.html,0.282
248,2014-15,New Mexico State,WAC,14,14,483,72,117,0.615,72,117,0.615,0,0,51,62,0.823,50,68,118,18,14,22,26,31,195,/players/pascal-siakam-1.html,0.0
249,2015-16,New Mexico State,WAC,14,14,486,107,196,0.546,105,191,0.55,2,5,47,74,0.635,57,116,173,29,16,39,27,41,263,/players/pascal-siakam-1.html,0.4
250,2015-16,LSU,SEC,18,17,647,117,213,0.549,117,212,0.552,0,1,128,193,0.663,50,153,203,85,35,9,69,52,362,/players/ben-simmons-1.html,0.0
251,2010-11,Duke,ACC,16,16,581,90,231,0.39,64,142,0.451,26,89,47,61,0.77,44,80,124,28,10,4,33,39,253,/players/kyle-singler-1.html,0.292
252,2012-13,Oklahoma State,Big 12,18,17,605,89,208,0.428,71,148,0.48,18,60,97,125,0.776,25,73,98,68,58,7,58,47,293,/players/marcus-smart-1.html,0.3
253,2013-14,Oklahoma State,Big 12,15,15,519,77,196,0.393,53,110,0.482,24,86,101,132,0.765,27,73,100,78,41,8,36,51,279,/players/marcus-smart-1.html,0.279
254,2016-17,NC State,ACC,18,18,641,109,234,0.466,77,143,0.538,32,91,77,117,0.658,20,70,90,112,35,8,67,40,327,/players/dennis-smithjr-1.html,0.352
255,2019-20,Washington,Pac-12,18,18,603,87,169,0.515,83,157,0.529,4,12,86,109,0.789,47,107,154,18,13,44,43,42,264,/players/isaiah-stewart-2.html,0.333
256,2014-15,Ohio State,Big Ten,18,12,436,77,125,0.616,75,111,0.676,2,14,36,65,0.554,37,53,90,6,13,9,17,44,192,/players/jaesean-tate-1.html,0.143
257,2015-16,Ohio State,Big Ten,15,15,447,76,144,0.528,71,129,0.55,5,15,22,41,0.537,31,57,88,24,15,3,21,48,179,/players/jaesean-tate-1.html,0.333
258,2016-17,Ohio State,Big Ten,18,18,570,103,195,0.528,97,171,0.567,6,24,42,75,0.56,30,81,111,39,22,10,44,62,254,/players/jaesean-tate-1.html,0.25
259,2017-18,Ohio State,Big Ten,18,18,557,91,163,0.558,85,143,0.594,6,20,43,67,0.642,24,86,110,52,22,14,38,52,231,/players/jaesean-tate-1.html,0.3
260,2016-17,Duke,ACC,18,18,605,98,221,0.443,68,141,0.482,30,80,64,75,0.853,26,104,130,40,21,18,50,52,290,/players/jayson-tatum-1.html,0.375
261,2010-11,Washington,Pac-10,18,18,589,92,213,0.432,58,115,0.504,34,98,85,112,0.759,12,52,64,121,22,1,60,46,303,/players/isaiah-thomas-1.html,0.347
262,2010-11,Washington State,Pac-10,17,16,606,117,286,0.409,66,161,0.41,51,125,68,80,0.85,19,79,98,63,25,21,66,54,353,/players/klay-thompson-1.html,0.408
263,2010-11,Texas,Big 12,16,16,501,83,149,0.557,83,149,0.557,0,0,68,137,0.496,56,66,122,23,11,40,29,45,234,/players/tristan-thompson-2.html,0.0
264,2015-16,Washington,Pac-12,18,18,480,43,108,0.398,21,49,0.429,22,59,25,34,0.735,18,41,59,28,22,16,26,62,133,/players/matisse-thybulle-1.html,0.373
265,2016-17,Washington,Pac-12,18,18,575,70,169,0.414,39,82,0.476,31,87,14,17,0.824,14,46,60,30,39,10,35,52,185,/players/matisse-thybulle-1.html,0.356
266,2017-18,Washington,Pac-12,18,18,586,70,153,0.458,38,77,0.494,32,76,19,29,0.655,18,38,56,42,49,22,35,48,191,/players/matisse-thybulle-1.html,0.421
267,2018-19,Washington,Pac-12,18,18,572,58,129,0.45,35,61,0.574,23,68,37,45,0.822,19,40,59,45,71,46,42,47,176,/players/matisse-thybulle-1.html,0.338
268,2014-15,Kentucky,SEC,18,18,388,70,120,0.583,69,117,0.59,1,3,53,65,0.815,42,75,117,22,8,43,21,61,194,/players/karl-anthony-towns-1.html,0.333
269,2014-15,Texas,Big 12,18,6,438,62,148,0.419,54,110,0.491,8,38,47,59,0.797,22,95,117,5,4,52,27,42,179,/players/myles-turner-1.html,0.211
270,2012-13,Wichita State,MVC,18,0,304,28,77,0.364,19,53,0.358,9,24,8,11,0.727,8,24,32,48,18,2,18,16,73,/players/fred-van-vleet-1.html,0.375
271,2013-14,Wichita State,MVC,18,18,562,68,137,0.496,49,90,0.544,19,47,68,82,0.829,20,59,79,97,33,2,23,35,223,/players/fred-van-vleet-1.html,0.404
272,2014-15,Wichita State,MVC,18,18,538,73,154,0.474,50,101,0.495,23,53,65,79,0.823,17,63,80,97,28,3,32,29,234,/players/fred-van-vleet-1.html,0.434
273,2015-16,Wichita State,MVC,18,18,531,72,177,0.407,45,111,0.405,27,66,55,63,0.873,6,59,65,115,32,2,29,31,226,/players/fred-van-vleet-1.html,0.409
274,2010-11,USC,Pac-10,18,18,633,133,246,0.541,113,199,0.568,20,47,64,82,0.78,55,139,194,20,10,18,21,47,350,/players/nikola-vucevic-1.html,0.426
275,2019-20,Michigan,Big Ten,20,20,651,93,205,0.454,61,98,0.622,32,107,42,51,0.824,20,104,124,23,26,14,30,51,260,/players/franz-wagner-1.html,0.299
276,2020-21,Michigan,Big Ten,17,17,557,84,168,0.5,58,104,0.558,26,64,39,47,0.83,12,92,104,49,25,20,22,34,233,/players/franz-wagner-1.html,0.406
277,2010-11,Syracuse,Big East,17,0,273,29,92,0.315,18,50,0.36,11,42,15,19,0.789,8,21,29,24,19,3,16,22,84,/players/dion-waiters-1.html,0.262
278,2011-12,Syracuse,Big East,18,0,454,75,172,0.436,57,116,0.491,18,56,41,61,0.672,12,39,51,46,32,7,24,35,209,/players/dion-waiters-1.html,0.321
279,2010-11,UConn,Big East,18,18,700,131,332,0.395,96,226,0.425,35,106,94,124,0.758,23,72,95,81,30,2,33,25,391,/players/kemba-walker-1.html,0.33
280,2017-18,Kentucky,SEC,18,11,496,66,134,0.493,64,121,0.529,2,13,64,103,0.621,32,66,98,24,19,15,31,50,198,/players/pj-washington-1.html,0.154
281,2018-19,Kentucky,SEC,18,18,553,104,197,0.528,83,150,0.553,21,47,61,93,0.656,38,80,118,29,15,17,34,49,290,/players/pj-washington-1.html,0.447
282,2018-19,UNC,ACC,18,18,537,111,246,0.451,59,111,0.532,52,135,51,62,0.823,10,56,66,75,20,10,54,40,325,/players/coby-white-1.html,0.385
283,2013-14,Kansas,Big 12,18,18,588,99,219,0.452,74,151,0.49,25,68,94,123,0.764,49,63,112,32,23,17,44,55,317,/players/andrew-wiggins-1.html,0.368
284,2010-11,Arizona,Pac-10,18,18,556,103,172,0.599,87,143,0.608,16,29,111,159,0.698,48,114,162,19,14,11,51,56,333,/players/derrick-williams-2.html,0.552
285,2019-20,Florida State,ACC,18,0,427,56,132,0.424,46,99,0.465,10,33,40,49,0.816,28,52,80,10,16,23,29,33,162,/players/patrick-williams-2.html,0.303
286,2016-17,Texas A&M,SEC,18,15,505,97,179,0.542,96,167,0.575,1,12,37,72,0.514,64,108,172,25,14,45,37,39,232,/players/robert-williams-3.html,0.083
287,2017-18,Texas A&M,SEC,17,14,437,89,140,0.636,89,132,0.674,0,8,25,49,0.51,43,101,144,19,10,39,27,36,203,/players/robert-williams-3.html,0.0
288,2018-19,Duke,ACC,13,13,385,113,161,0.702,103,134,0.769,10,27,58,90,0.644,42,68,110,29,27,23,30,27,294,/players/zion-williamson-1.html,0.37
289,2014-15,Duke,ACC,18,18,560,88,177,0.497,66,124,0.532,22,53,41,69,0.594,25,96,121,37,26,17,34,58,239,/players/justise-winslow-1.html,0.415
290,2017-18,Oklahoma,Big 12,18,18,669,143,364,0.393,81,174,0.466,62,190,145,168,0.863,9,67,76,145,30,5,110,39,493,/players/trae-young-1.html,0.326
291,2011-12,Indiana,Big Ten,18,18,514,101,164,0.616,101,164,0.616,0,0,77,101,0.762,37,68,105,20,16,20,31,57,279,/players/cody-zeller-1.html,0.0
292,2012-13,Indiana,Big Ten,18,18,555,103,192,0.536,103,192,0.536,0,0,102,131,0.779,52,95,147,23,21,24,45,44,308,/players/cody-zeller-1.html,0.0
293,2010-11,UNC,ACC,16,14,447,87,150,0.58,87,150,0.58,0,0,58,79,0.734,49,56,105,3,9,15,21,44,232,/players/tyler-zeller-1.html,0.0
294,2011-12,UNC,ACC,16,16,459,103,181,0.569,103,181,0.569,0,0,90,108,0.833,64,91,155,11,17,30,33,49,296,/players/tyler-zeller-1.html,0.0
